*X*************
*5      2 *  M*
* *** ** **** ***********
***  M*   1   * 3  M  2 *
* ***** ***** ***********
* 3  * L ** *F*
*M**M***   FFF******
* 1********FFF**5***
*************Y******