***X*******************
** 1 *  3   * 2 * L 1 *
***  *     ** M * 2   *
* M  * FFF  * 3 *******
********Y**************