*X*************
*       2  *  *
* *** ** **** *
* *  M*   1  M*
* ***** ***** *
*  2 *   ** *F*
* ** ***  F   *
*M1********F L*
*************Y*