**X****
*    **
*M** **
*  *F**
*  FL**
****Y**