*X******************************************8*************
*      M   *  ********************6     *       *8    FL *
* *** **F**** ****** 2  ** M******  M   *   M   *F**  FFF*
* *  M*       ****** *    1 ******     7*FFFFFFF*       7*
* *****F***** ******************************Y*************
*  M *  F** * ***************************
* ** *** 3    ***************************
* 3******** 1 ******2   4*4     5*5    6*
*****************************************