*X*************
*       2 *  M*
* *** ** **** *
* *  M*   1   *
* ***** ***** *
*  2 *   ** *F*
*M**M*** L FFF*
* 1********FFF*
*************Y*